*******X*X
*X*XXX***X
*X*******X
*****XXXXX
***X*****X
***X*XXXXX
***X*****X
*X***XXXXX
*X*******X
XXXXXXXX**