*********X
*XXXXX*XXX
*X*X*****X
*X*XX*XXXX
*X*******X
XXX*XXXXXX
*X***X***X
*XX*XXXX*X
*********X
XXXXXXXX**
